1111111111111111111111111111111111111111111111
1C00000000000000000000000000000000000000000001
1E00000000000C11111110000000000000000000000001
1P011111000000000000011111110000000C0000C00001
100000000000000C000000C0000C0000000000000C0001
1C00000000000000000000011111111111000000000001
1C00000000000000000000000000000000000000000001
1C00000000000000000000C00000000000111111110001
11111111100000000000C0000000011111111111100001
1C00000000000000000000000000000000000000000001
1C000000000000000000C0000000000000000000000001
1100000000011111111111111111100000000000000001
1C00000000000000000000000000000000000000000001
1C0000000000000C0000N0001111111111111110000001
1C00000000000000000001000000000000000000000001
1C0111111111110000N00CCCCCCCCCCCCCCCCC00000001
1111111111111111111111111111111111111111111111