1111111111111111111111111111111111111111111111
1C0000000N00000000111111111111110N000000000001
1E000000N0000C11111110CCCC000N1111000N11111111
1P01111100000000000001111111000N000C0000C00001
10000N000000000C000000C0000C0000000000000C0001
1C00000000000000000000011111111111000000000001
1C00000000000000000000000000000000000000000001
1C000N000N000000000000C00000000000111111110001
11111111100000000000C0000000011111111111100001
1000000000000000N00000000000000000000000000001
10000000000CCCCCCCCCC0000000000000000000000001
110000000001111111111111111110000000N000000001
111111111000000000000000000000C000000000000111
1C0000000000000C000000001111111111111110000N01
1C0000N00000000000N000000000000111111111111111
1C0111111111110000N00CCCCCCCCCCCCCCCCC00000001
1111111111111111111111111111111111111111111111