111111111111111111111111111111
1E00000000000C11111110CCCC0001
1000000C000000CCCCCCC000001111
1C111P111110000001111110000001
111111111111111111111111111111